┌───┬───────────────┬───────────────────┬───────────────────┬───────────┐
│   │               │                   │                   │           │
│   │   ┌───┐   ╷   │   ┌───┐   ╷   ┌───┘   ┌───────┐   ╷   └───╴   ╷   │
│   │   │   │   │   │   │   │   │   │       │       │   │           │   │
│   ╵   │   │   ├───┘   │   │   │   ╵   ┌───┘   ╷   ╵   ├───────┬───┘   │
│       │   │   │       │   │   │       │       │       │       │       │
│   ┌───┘   │   ╵   ┌───┤   └───┴───────┤   ┌───┴───────┤   ╷   ╵   ╶───┤
│   │       │       │   │               │   │           │   │           │
│   └───╴   └───┬───┘   ├───┬───────╴   │   │   ╶───┐   ├───┴───┬───┐   │
│               │       │ @ │           │   │       │   │       │   │   │
├───────┬───┐   ╵   ╷   ╵   │   ┌───────┘   ├───╴   │   ╵   ╷   │   ╵   │
│       │   │       │       │   │           │       │       │   │       │
│   ╷   ╵   ├───────┘   ┌───┘   │   ╶───────┘   ┌───┴───────┤   └───────┤
│   │       │           │       │               │           │           │
│   └───┐   │   ┌───────┤   ╶───┴───────────────┤   ┌───╴   │   ╶───┐   │
│       │   │   │       │                       │   │       │       │   │
├───╴   │   │   └───╴   └───────┬───┬───────╴   │   │   ╶───┴───┬───┘   │
│       │   │                   │   │           │   │           │       │
│   ┌───┘   ├───────┬───┬───╴   │   │   ╶───┬───┘   └───────┐   ╵   ╷   │
│   │       │       │   │       │   │       │ $             │       │   │
│   └───┐   ╵   ╷   ╵   │   ╶───┘   ├───┐   └───┐   ╶───┐   └───┬───┤   │
│       │       │       │           │   │       │       │       │   │   │
│   ╷   └───────┴───────┴───────╴   ╵   └───┐   └───────┴───╴   │   ╵   │
│   │                                       │                   │       │
└───┴───────────────────────────────────────┴───────────────────┴───────┘